   WE                          textures/wolfenstein/greystone.png
NO      textures/wolfenstein/bluestone.png



SO textures/wolfenstein/wood.png

F      17,    38,     64

EA textures/wolfenstein/wood.png


C 218, 234, 235



1111111111111111111
10N0000000000000001
1000000000000000001
1000000000000000001
1000000000000000001
1000000000000000001
1000000000000000001
1000000000000000001
1000000000000000001
1111111111111111111
