
NO      textures/wolfenstein/purplestone.png   
   WE                          textures/wolfenstein/greystone.png
EA textures/wolfenstein/wood.png
SO textures/wolfenstein/redbrick.png




F 20, 20, 20
C 200,200,200


11111
1S001
10001
10001
10001
10001
11001
10001
10001
10001
10001
10001
11111
