1111111111111111111
10W0000000000000001
1000000000000000001
1000000000000000001
1000000000000000001
1000000000000000001
1000000000000000001
1000000000000000001
1000000000000000001
1111111111111111111


1111111111111111111
1001001001001000001
1011000001000001001
1001001001111101111
1001111000001001001
100000000W000001001
1001111111111001001
1111000000000001011
1000000001000000001
1111111111111111111